2222222222222222222
2000000200020000002
2000000200020000002
2000000220220000002
2000000000000000002
2000000000000000002
2000000000000000002
2000000000000000002
2000000000000000002
2000000000000000002
2000000000000000002
2000000000000000002
2000000000000000002
2000000000000000002
2211122221111111112
2000000220220000002
2000000200020000002
2000000200020000002
2222222222222222222