2222222222222222222
2000000200020000002
2000000200020000002
2000000220220000002
2000000000000000002
2000000000000000002
2000000000000000002
2000000000000000002
2000000000000000002
2000000000000000002
2000000000000000002
2000000000000000002
2000000000000000002
2000000000000000002
2200022220000000002
2000000220220000002
2000000200020000002
2000000200020000002
2222222222222222222